B93D515553
C6C53C5396
B939693AC7
86AC3AAC53
C7C546C556

0,0
8,4
test
